############
#S.........#
#.########.#
#........#.#
########.#.#
#........#.#
#.########.#
#........#.#
########.#.#
#..........#
#.########E#
############