################
#S.............#
#.###########..#
#.#.........#..#
#.#.#######.#..#
#.#.#.....#.#..#
#.#.#.###.#.#..#
#.#.#.#.#.#.#..#
#.#.#.#.#.#.#..#
#.#.#.#.#.#.#..#
#...#.#.#.#.#..#
#####.#.#.#.#..#
#.....#.#.....##
#.#####.#######E
################