##########
#S..#....#
###.#.##.#
#....#.#.#
#.###.#..#
#.....#..#
###.####.#
#........#
#.#####.E#
##########